0000000000
0000000000
0000000000
0012222100
0111111110
0211221120
0111111110
0012222100
0000000000
0000000000
