0000000000
0000000000
0000000000
0000000000
0000000000
0111511110
1353531351
1511511511
0211211210
1511511511
