0000000000
0111001110
0100000010
0111331110
0121551210
0121331210
0100330010
0100110010
0446446440
0000000000
